1111111111111111111111111111111111111111
10000000000000110C0000000000000000000C01
1010010100111000001010000000100000001101
1010010010111010111000100001111111100001
1P000000011C000C000000000000000000000001
1E01100001000000000000000000000000000001
1010010111001000000001000100100000010101
1010010010101010000010000000111100010101
1000011001111000000000000000000000000001
10C0000000000000000000000000C00000000001
1000010010110010010000010100001110C10101
101001000110011101010100010000C011110101
100000001000C0000000111110000000000000C1
1111111111111111111111111111111111111111