1111111111111
1001000C00031
100P011111001
1P0011E000001
1111111111111